########
A      #
# #### #
#      #
# #### #
#      #
# #### #
B      #
########