########################################################################################
A                                                                                    #
# ################################################################################# #
#                                                                                   #
# ################################################################################# #
#                                                                                   #
# ################################################################################# #
#                                                                                   #
# ################################################################################# #
#                                                                                   #
# ################################################################################# #
#                                                                                   #
# ################################################################################# #
#                                                                                   #
# ################################################################################# #
#                                                                                   #
# ################################################################################# #
#                                                                                   #
# ################################################################################# #
#                                                                                   #
# ################################################################################# #
#                                                                                   #
# ################################################################################# #
#                                                                                   #
# ################################################################################# #
#                                                                                   #
# ################################################################################# #
#                                                                                   #
# ################################################################################# #
#                                                                                   #
# ################################################################################# #
#                                                                                   #
# ################################################################################# #
#                                                                                   #
# ################################################################################# #
#                                                                                   #
# ################################################################################# #
#                                                                                   #
# ################################################################################# #
#                                                                                   #
# ################################################################################# #
#                                                                                   #
# ################################################################################# #
#                                                                                   #
# ################################################################################# #
#                                                                                   #
# ################################################################################# #
#                                                                                   #
# ################################################################################# #
#                                                                                   #
# ################################################################################# #
#                                                                                   #
# ################################################################################# #
#                                                                                   #
# ################################################################################# #
#                                                                                   #
# ################################################################################# #
#                                                                                   #
# ################################################################################# #
#                                                                                   #
# ################################################################################# #
#                                                                                   #
# ################################################################################# #
#                                                                                   #
# ################################################################################# #
#                                                                                   #
# ################################################################################# #
#                                                                                   #
# ################################################################################# #
#                                                                                   #
# ################################################################################# #
#                                                                                   #
# ################################################################################# #
#                                                                                   #
# ################################################################################# #
#                                                                                   #
# ################################################################################# #
#                                                                                   #
# ################################################################################# #
#                                                                                   #
# ################################################################################# #
#                                                                                   #
# ################################################################################# #
#                                                                                   #
# ################################################################################# #
#                                                                                   #
# ################################################################################# #
#                                                                                   #
# ################################################################################# #
#                                                                                   #
# ################################################################################# #
#                                                                                   #
# ################################################################################# #
#                                                                                   #
# #################################################################################B#
########################################################################################
