####################
A                  #
# ################ #
#   #              #
# # ############# #
# # #             #
# # # #############
# # #             #
# # ############# #
# #             # #
# ############# # #
#               # #
# ############# # #
#               # #
# ############# # #
#               # #
# ############# # #
#               #B#
####################