####################
A            #######
############ #      #
#            ####   #
# ##########        #
#                  ##
# ###########      ##
#                  ##
# #############    ##
#                  ##
# ###########      ##
#                  ##
# #############    ##
#                  ##
# ###########      ##
#                  ##
# #############    ##
#                  ##
# ###########      ##
#                  B #
######################